***********
*         *
* ** * ** *
* *     * *
* * *** * *
*         *
* * *** * *
* *  P  * *
* ** * ** *
*    *    *
***********
