__________******************
__________*                *
__________***** ********** *
______________* *________* *
______________* *________* *
*************** ********** ****
*P                            *
******* ****************** ****
______* *________________* *
______* *________________* *
___**** ****_____________***
___*       *
___**** ****
______***
